Id,Date,Schl,Loc,Opp,Result,MP,Tm_FG,Tm_FGA,Tm_FG%,Tm_2P,Tm_2PA,Tm_2P%,Tm_3P,Tm_3PA,Tm_3P%,Tm_FT,Tm_FTA,Tm_FT%,Tm_PTS,Opp_FG,Opp_FGA,Opp_FG%,Opp_2P,Opp_2PA,Opp_2P%,Opp_3P,Opp_3PA,Opp_3P%,Opp_FT,Opp_FTA,Opp_FT%,Opp_PTS
1,2022-11-27,Gonzaga,N,Xavier,W 88-84,200,31,62,.500,18,38,.474,13,24,.542,13,19,.684,88,35,68,.515,27,53,.509,8,15,.533,6,8,.750,84
2,2022-11-25,Gonzaga,N,Portland State,W 102-78,200,38,63,.603,26,39,.667,12,24,.500,14,20,.700,102,26,61,.426,15,36,.417,11,25,.440,15,17,.882,78
3,2022-11-25,Gonzaga,N,Purdue,L 66-84,200,27,67,.403,18,39,.462,9,28,.321,3,4,.750,66,29,61,.475,19,35,.543,10,26,.385,16,22,.727,84
4,2022-11-20,Gonzaga,,Kentucky,W 88-72,200,31,55,.564,24,36,.667,7,19,.368,19,21,.905,88,27,69,.391,21,44,.477,6,25,.240,12,16,.750,72
5,2022-11-16,Gonzaga,@,Texas,L 74-93,200,25,51,.490,16,32,.500,9,19,.474,15,21,.714,74,34,66,.515,21,33,.636,13,33,.394,12,16,.750,93
6,2022-11-11,Gonzaga,N,Michigan State,W 64-63,200,23,55,.418,19,37,.514,4,18,.222,14,22,.636,64,21,52,.404,18,36,.500,3,16,.188,18,28,.643,63
7,2022-11-07,Gonzaga,,North Florida,W 104-63,200,43,67,.642,38,55,.691,5,12,.417,13,16,.813,104,21,59,.356,13,29,.448,8,30,.267,13,22,.591,63
8,2022-03-24,Gonzaga,N,Arkansas,L 68-74,200,24,64,.375,19,43,.442,5,21,.238,15,20,.750,68,29,72,.403,22,47,.468,7,25,.280,9,14,.643,74
9,2022-03-19,Gonzaga,N,Memphis,W 82-78,200,30,58,.517,21,31,.677,9,27,.333,13,24,.542,82,30,70,.429,26,51,.510,4,19,.211,14,20,.700,78
10,2022-03-17,Gonzaga,N,Georgia State,W 93-72,200,36,71,.507,31,53,.585,5,18,.278,16,30,.533,93,23,70,.329,17,54,.315,6,16,.375,20,25,.800,72
11,2022-03-08,Gonzaga,N,Saint Mary's,W 82-69,200,30,52,.577,22,36,.611,8,16,.500,14,18,.778,82,27,57,.474,22,41,.537,5,16,.313,10,12,.833,69
12,2022-03-07,Gonzaga,N,San Francisco,W 81-71,200,32,55,.582,29,42,.690,3,13,.231,14,18,.778,81,24,63,.381,13,29,.448,11,34,.324,12,18,.667,71
13,2022-02-26,Gonzaga,@,Saint Mary's,L 57-67,200,22,60,.367,17,45,.378,5,15,.333,8,9,.889,57,27,61,.443,21,45,.467,6,16,.375,7,8,.875,67
14,2022-02-24,Gonzaga,@,San Francisco,W 89-73,200,34,62,.548,24,42,.571,10,20,.500,11,13,.846,89,27,65,.415,16,43,.372,11,22,.500,8,17,.471,73
15,2022-02-19,Gonzaga,,Santa Clara,W 81-69,200,27,67,.403,15,32,.469,12,35,.343,15,20,.750,81,24,58,.414,18,47,.383,6,11,.545,15,19,.789,69
16,2022-02-16,Gonzaga,@,Pepperdine,W 86-66,200,34,66,.515,30,48,.625,4,18,.222,14,15,.933,86,24,64,.375,18,44,.409,6,20,.300,12,16,.750,66
17,2022-02-12,Gonzaga,,Saint Mary's,W 74-58,200,30,55,.545,24,43,.558,6,12,.500,8,13,.615,74,23,59,.390,18,42,.429,5,17,.294,7,9,.778,58
18,2022-02-10,Gonzaga,,Pacific,W 89-51,200,35,68,.515,24,40,.600,11,28,.393,8,10,.800,89,20,64,.313,17,43,.395,3,21,.143,8,12,.667,51
19,2022-02-05,Gonzaga,@,BYU,W 90-57,200,32,61,.525,24,40,.600,8,21,.381,18,22,.818,90,21,71,.296,15,45,.333,6,26,.231,9,11,.818,57
20,2022-02-03,Gonzaga,@,San Diego,W 92-62,200,38,67,.567,33,55,.600,5,12,.417,11,16,.688,92,22,62,.355,17,48,.354,5,14,.357,13,19,.684,62
21,2022-01-29,Gonzaga,,Portland,W 104-72,200,34,71,.479,16,30,.533,18,41,.439,18,24,.750,104,25,70,.357,22,47,.468,3,23,.130,19,22,.864,72
22,2022-01-27,Gonzaga,,Loyola Marymount,W 89-55,200,34,55,.618,22,32,.688,12,23,.522,9,12,.750,89,22,67,.328,16,45,.356,6,22,.273,5,8,.625,55
23,2022-01-20,Gonzaga,,San Francisco,W 78-62,200,28,60,.467,23,42,.548,5,18,.278,17,22,.773,78,22,61,.361,16,40,.400,6,21,.286,12,14,.857,62
24,2022-01-15,Gonzaga,@,Santa Clara,W 115-83,200,44,75,.587,32,49,.653,12,26,.462,15,19,.789,115,31,78,.397,23,52,.442,8,26,.308,13,21,.619,83
25,2022-01-13,Gonzaga,,BYU,W 110-84,200,43,62,.694,32,41,.780,11,21,.524,13,20,.650,110,32,74,.432,19,45,.422,13,29,.448,7,10,.700,84
26,2022-01-08,Gonzaga,,Pepperdine,W 117-83,200,45,83,.542,35,58,.603,10,25,.400,17,23,.739,117,32,75,.427,22,48,.458,10,27,.370,9,12,.750,83
27,2021-12-28,Gonzaga,,North Alabama,W 93-63,200,34,69,.493,27,46,.587,7,23,.304,18,31,.581,93,23,71,.324,15,42,.357,8,29,.276,9,13,.692,63
28,2021-12-20,Gonzaga,,Northern Ariz.,W 95-49,200,33,60,.550,23,38,.605,10,22,.455,19,23,.826,95,21,65,.323,16,43,.372,5,22,.227,2,3,.667,49
29,2021-12-18,Gonzaga,N,Texas Tech,W 69-55,200,24,56,.429,11,25,.440,13,31,.419,8,10,.800,69,21,56,.375,15,37,.405,6,19,.316,7,13,.538,55
30,2021-12-09,Gonzaga,,Merrimack,W 80-55,200,30,59,.508,25,37,.676,5,22,.227,15,20,.750,80,20,63,.317,14,38,.368,6,25,.240,9,11,.818,55
31,2021-12-04,Gonzaga,N,Alabama,L 82-91,200,30,67,.448,21,44,.477,9,23,.391,13,25,.520,82,31,72,.431,18,38,.474,13,34,.382,16,22,.727,91
32,2021-11-29,Gonzaga,,Tarleton State,W 64-55,200,23,49,.469,19,30,.633,4,19,.211,14,24,.583,64,21,56,.375,16,39,.410,5,17,.294,8,14,.571,55
33,2021-11-26,Gonzaga,N,Duke,L 81-84,200,34,64,.531,28,43,.651,6,21,.286,7,11,.636,81,31,67,.463,24,44,.545,7,23,.304,15,25,.600,84
34,2021-11-23,Gonzaga,N,UCLA,W 83-63,200,28,50,.560,19,27,.704,9,23,.391,18,23,.783,83,24,69,.348,22,57,.386,2,12,.167,13,18,.722,63
35,2021-11-22,Gonzaga,N,Central Mich.,W 107-54,200,42,73,.575,33,41,.805,9,32,.281,14,25,.560,107,17,56,.304,8,33,.242,9,23,.391,11,16,.688,54
36,2021-11-19,Gonzaga,,Bellarmine,W 92-50,200,32,60,.533,21,37,.568,11,23,.478,17,21,.810,92,21,53,.396,18,28,.643,3,25,.120,5,6,.833,50
37,2021-11-15,Gonzaga,,Alcorn State,W 84-57,200,34,58,.586,27,39,.692,7,19,.368,9,12,.750,84,25,62,.403,22,51,.431,3,11,.273,4,7,.571,57
38,2021-11-13,Gonzaga,,Texas,W 86-74,200,32,59,.542,25,40,.625,7,19,.368,15,17,.882,86,26,59,.441,17,35,.486,9,24,.375,13,16,.813,74
39,2021-11-09,Gonzaga,,Utah Tech,W 97-63,200,37,68,.544,31,47,.660,6,21,.286,17,24,.708,97,23,65,.354,15,43,.349,8,22,.364,9,21,.429,63
40,2021-04-05,Gonzaga,N,Baylor,L 70-86,200,25,49,.510,20,32,.625,5,17,.294,15,21,.714,70,30,67,.448,20,44,.455,10,23,.435,16,18,.889,86
41,2021-04-03,Gonzaga,N,UCLA,W 93-90 (OT),225,37,63,.587,30,42,.714,7,21,.333,12,20,.600,93,34,59,.576,26,42,.619,8,17,.471,14,21,.667,90
42,2021-03-30,Gonzaga,N,USC,W 85-66,200,33,66,.500,26,45,.578,7,21,.333,12,17,.706,85,24,62,.387,20,47,.426,4,15,.267,14,19,.737,66
43,2021-03-28,Gonzaga,N,Creighton,W 83-65,200,34,57,.596,25,33,.758,9,24,.375,6,10,.600,83,28,69,.406,23,46,.500,5,23,.217,4,8,.500,65
44,2021-03-22,Gonzaga,N,Oklahoma,W 87-71,200,28,57,.491,20,35,.571,8,22,.364,23,26,.885,87,29,58,.500,24,42,.571,5,16,.313,8,12,.667,71
45,2021-03-20,Gonzaga,N,Norfolk State,W 98-55,200,34,61,.557,20,34,.588,14,27,.519,16,18,.889,98,19,62,.306,12,41,.293,7,21,.333,10,16,.625,55
46,2021-03-09,Gonzaga,N,BYU,W 88-78,200,29,57,.509,17,31,.548,12,26,.462,18,27,.667,88,31,67,.463,20,39,.513,11,28,.393,5,7,.714,78
47,2021-03-08,Gonzaga,N,Saint Mary's,W 78-55,200,33,62,.532,28,47,.596,5,15,.333,7,11,.636,78,22,61,.361,20,41,.488,2,20,.100,9,12,.750,55
48,2021-02-27,Gonzaga,,Loyola Marymount,W 86-69,200,28,48,.583,19,31,.613,9,17,.529,21,32,.656,86,26,53,.491,20,38,.526,6,15,.400,11,17,.647,69
49,2021-02-25,Gonzaga,,Santa Clara,W 89-75,200,33,64,.516,26,40,.650,7,24,.292,16,21,.762,89,31,67,.463,25,49,.510,6,18,.333,7,12,.583,75
50,2021-02-20,Gonzaga,,San Diego,W 106-69,200,40,72,.556,35,53,.660,5,19,.263,21,25,.840,106,28,64,.438,23,44,.523,5,20,.250,8,17,.471,69
51,2021-02-18,Gonzaga,,Saint Mary's,W 87-65,200,33,54,.611,25,40,.625,8,14,.571,13,17,.765,87,25,55,.455,19,35,.543,6,20,.300,9,10,.900,65
52,2021-02-13,Gonzaga,@,San Francisco,W 100-61,200,36,59,.610,26,38,.684,10,21,.476,18,21,.857,100,21,60,.350,14,27,.519,7,33,.212,12,15,.800,61
53,2021-02-08,Gonzaga,@,BYU,W 82-71,200,32,63,.508,26,45,.578,6,18,.333,12,21,.571,82,28,58,.483,20,37,.541,8,21,.381,7,10,.700,71
54,2021-02-04,Gonzaga,@,Pacific,W 76-58,200,25,50,.500,21,33,.636,4,17,.235,22,29,.759,76,24,61,.393,21,48,.438,3,13,.231,7,15,.467,58
55,2021-01-30,Gonzaga,@,Pepperdine,W 97-75,200,37,62,.597,28,35,.800,9,27,.333,14,17,.824,97,26,63,.413,19,41,.463,7,22,.318,16,19,.842,75
56,2021-01-28,Gonzaga,@,San Diego,W 90-62,200,34,59,.576,26,40,.650,8,19,.421,14,21,.667,90,25,57,.439,17,41,.415,8,16,.500,4,8,.500,62
57,2021-01-23,Gonzaga,,Pacific,W 95-49,200,31,63,.492,19,37,.514,12,26,.462,21,27,.778,95,19,68,.279,17,52,.327,2,16,.125,9,17,.529,49
58,2021-01-16,Gonzaga,@,Saint Mary's,W 73-59,200,28,52,.538,24,41,.585,4,11,.364,13,15,.867,73,22,63,.349,13,40,.325,9,23,.391,6,8,.750,59
59,2021-01-14,Gonzaga,,Pepperdine,W 95-70,200,34,64,.531,25,41,.610,9,23,.391,18,27,.667,95,24,59,.407,17,40,.425,7,19,.368,15,20,.750,70
60,2021-01-09,Gonzaga,@,Portland,W 116-88,200,44,70,.629,40,53,.755,4,17,.235,24,30,.800,116,28,67,.418,15,40,.375,13,27,.481,19,22,.864,88
61,2021-01-07,Gonzaga,,BYU,W 86-69,200,32,65,.492,25,45,.556,7,20,.350,15,20,.750,86,27,61,.443,23,45,.511,4,16,.250,11,14,.786,69
62,2021-01-02,Gonzaga,,San Francisco,W 85-62,200,30,57,.526,25,42,.595,5,15,.333,20,26,.769,85,21,54,.389,13,31,.419,8,23,.348,12,16,.750,62
63,2020-12-29,Gonzaga,,Utah Tech,W 112-67,200,44,73,.603,36,50,.720,8,23,.348,16,24,.667,112,24,56,.429,20,41,.488,4,15,.267,15,22,.682,67
64,2020-12-28,Gonzaga,,Northern Ariz.,W 88-58,200,32,64,.500,25,36,.694,7,28,.250,17,27,.630,88,20,57,.351,15,40,.375,5,17,.294,13,18,.722,58
65,2020-12-26,Gonzaga,N,Virginia,W 98-75,200,35,58,.603,25,38,.658,10,20,.500,18,23,.783,98,26,54,.481,16,29,.552,10,25,.400,13,16,.813,75
66,2020-12-22,Gonzaga,,NW St.,W 95-78,200,39,67,.582,35,49,.714,4,18,.222,13,20,.650,95,31,66,.470,19,42,.452,12,24,.500,4,8,.500,78
67,2020-12-21,Gonzaga,,NW St.,W 95-57,200,33,60,.550,25,39,.641,8,21,.381,21,28,.750,95,21,56,.375,14,31,.452,7,25,.280,8,10,.800,57
68,2020-12-19,Gonzaga,N,Iowa,W 99-88,200,36,70,.514,23,44,.523,13,26,.500,14,24,.583,99,35,75,.467,31,53,.585,4,22,.182,14,26,.538,88
69,2020-12-02,Gonzaga,N,West Virginia,W 87-82,200,34,69,.493,30,53,.566,4,16,.250,15,21,.714,87,25,66,.379,20,49,.408,5,17,.294,27,33,.818,82
70,2020-11-27,Gonzaga,N,Auburn,W 90-67,200,36,68,.529,30,47,.638,6,21,.286,12,17,.706,90,22,59,.373,11,24,.458,11,35,.314,12,15,.800,67
71,2020-11-26,Gonzaga,N,Kansas,W 102-90,200,40,62,.645,34,44,.773,6,18,.333,16,20,.800,102,33,62,.532,25,44,.568,8,18,.444,16,24,.667,90
72,2020-03-10,Gonzaga,N,Saint Mary's,W 84-66,200,31,58,.534,26,43,.605,5,15,.333,17,24,.708,84,21,46,.457,12,29,.414,9,17,.529,15,18,.833,66
73,2020-03-09,Gonzaga,N,San Francisco,W 81-77,200,30,60,.500,27,48,.563,3,12,.250,18,26,.692,81,30,64,.469,24,38,.632,6,26,.231,11,15,.733,77
74,2020-02-29,Gonzaga,,Saint Mary's,W 86-76,200,32,54,.593,25,41,.610,7,13,.538,15,18,.833,86,29,59,.492,23,40,.575,6,19,.316,12,14,.857,76
75,2020-02-27,Gonzaga,,San Diego,W 94-59,200,37,71,.521,29,53,.547,8,18,.444,12,19,.632,94,24,62,.387,20,50,.400,4,12,.333,7,10,.700,59
76,2020-02-22,Gonzaga,@,BYU,L 78-91,200,25,60,.417,20,35,.571,5,25,.200,23,28,.821,78,33,62,.532,22,35,.629,11,27,.407,14,18,.778,91
77,2020-02-20,Gonzaga,,San Francisco,W 71-54,200,29,58,.500,24,45,.533,5,13,.385,8,15,.533,71,22,66,.333,16,42,.381,6,24,.250,4,6,.667,54
78,2020-02-15,Gonzaga,@,Pepperdine,W 89-77,200,31,63,.492,23,46,.500,8,17,.471,19,27,.704,89,31,67,.463,26,47,.553,5,20,.250,10,12,.833,77
79,2020-02-08,Gonzaga,@,Saint Mary's,W 90-60,200,36,53,.679,28,38,.737,8,15,.533,10,14,.714,90,25,58,.431,21,44,.477,4,14,.286,6,10,.600,60
80,2020-02-06,Gonzaga,,Loyola Marymount,W 85-67,200,30,50,.600,23,30,.767,7,20,.350,18,25,.720,85,27,55,.491,21,39,.538,6,16,.375,7,12,.583,67
81,2020-02-01,Gonzaga,@,San Francisco,W 83-79,200,27,50,.540,23,45,.511,4,5,.800,25,32,.781,83,27,66,.409,20,38,.526,7,28,.250,18,25,.720,79
82,2020-01-30,Gonzaga,@,Santa Clara,W 87-72,200,34,69,.493,31,53,.585,3,16,.188,16,22,.727,87,29,68,.426,21,43,.488,8,25,.320,6,6,1.000,72
83,2020-01-25,Gonzaga,,Pacific,W 92-59,200,33,58,.569,24,40,.600,9,18,.500,17,29,.586,92,22,62,.355,17,45,.378,5,17,.294,10,16,.625,59
84,2020-01-18,Gonzaga,,BYU,W 92-69,200,32,57,.561,23,36,.639,9,21,.429,19,25,.760,92,29,57,.509,23,37,.622,6,20,.300,5,10,.500,69
85,2020-01-16,Gonzaga,,Santa Clara,W 104-54,200,34,66,.515,26,45,.578,8,21,.381,28,32,.875,104,21,69,.304,18,44,.409,3,25,.120,9,19,.474,54
86,2020-01-11,Gonzaga,@,Loyola Marymount,W 87-62,200,31,59,.525,23,37,.622,8,22,.364,17,27,.630,87,22,57,.386,15,31,.484,7,26,.269,11,17,.647,62
87,2020-01-09,Gonzaga,@,San Diego,W 94-50,200,36,74,.486,28,55,.509,8,19,.421,14,19,.737,94,20,61,.328,17,45,.378,3,16,.188,7,12,.583,50
88,2020-01-04,Gonzaga,,Pepperdine,W 75-70,200,28,57,.491,23,39,.590,5,18,.278,14,21,.667,75,28,64,.438,21,44,.477,7,20,.350,7,9,.778,70
89,2020-01-02,Gonzaga,@,Portland,W 85-72,200,33,65,.508,25,40,.625,8,25,.320,11,23,.478,85,29,56,.518,21,43,.488,8,13,.615,6,10,.600,72
90,2019-12-30,Gonzaga,,Detroit,W 93-72,200,33,65,.508,23,42,.548,10,23,.435,17,24,.708,93,27,64,.422,18,36,.500,9,28,.321,9,12,.750,72
91,2019-12-21,Gonzaga,,Eastern Wash.,W 112-77,200,35,73,.479,23,43,.535,12,30,.400,30,40,.750,112,29,65,.446,23,45,.511,6,20,.300,13,22,.591,77
92,2019-12-18,Gonzaga,,UNC,W 94-81,200,35,59,.593,26,41,.634,9,18,.500,15,22,.682,94,31,68,.456,24,49,.490,7,19,.368,12,17,.706,81
93,2019-12-14,Gonzaga,@,Arizona,W 84-80,200,29,61,.475,20,38,.526,9,23,.391,17,30,.567,84,30,78,.385,22,48,.458,8,30,.267,12,13,.923,80
94,2019-12-08,Gonzaga,@,Washington,W 83-76,200,33,69,.478,27,48,.563,6,21,.286,11,14,.786,83,28,55,.509,19,32,.594,9,23,.391,11,14,.786,76
95,2019-12-04,Gonzaga,,Texas Southern,W 101-62,200,42,78,.538,34,51,.667,8,27,.296,9,16,.563,101,23,58,.397,18,38,.474,5,20,.250,11,17,.647,62
96,2019-11-29,Gonzaga,N,Michigan,L 64-82,200,26,65,.400,20,53,.377,6,12,.500,6,13,.462,64,34,63,.540,22,40,.550,12,23,.522,2,5,.400,82
97,2019-11-28,Gonzaga,N,Oregon,W 73-72 (OT),225,24,62,.387,15,34,.441,9,28,.321,16,20,.800,73,27,80,.338,19,52,.365,8,28,.286,10,14,.714,72
98,2019-11-27,Gonzaga,N,Southern Miss,W 94-69,200,34,59,.576,21,40,.525,13,19,.684,13,20,.650,94,27,62,.435,16,40,.400,11,22,.500,4,6,.667,69
99,2019-11-23,Gonzaga,,Cal St Bakersfield,W 77-49,200,22,49,.449,14,26,.538,8,23,.348,25,39,.641,77,20,50,.400,17,40,.425,3,10,.300,6,9,.667,49
100,2019-11-19,Gonzaga,,UT Arlington,W 72-66,200,25,64,.391,20,42,.476,5,22,.227,17,30,.567,72,21,53,.396,10,27,.370,11,26,.423,13,17,.765,66
101,2019-11-15,Gonzaga,@,Texas A&M,W 79-49,200,31,63,.492,24,44,.545,7,19,.368,10,15,.667,79,17,56,.304,14,36,.389,3,20,.150,12,16,.750,49
102,2019-11-12,Gonzaga,,North Dakota,W 97-66,200,41,71,.577,34,55,.618,7,16,.438,8,14,.571,97,25,72,.347,18,41,.439,7,31,.226,9,11,.818,66
103,2019-11-09,Gonzaga,,Ark-Pine Bluff,W 110-60,200,35,56,.625,26,33,.788,9,23,.391,31,39,.795,110,23,56,.411,21,46,.457,2,10,.200,12,18,.667,60
104,2019-11-05,Gonzaga,,Alabama State,W 95-64,200,34,59,.576,24,39,.615,10,20,.500,17,27,.630,95,24,49,.490,15,33,.455,9,16,.563,7,12,.583,64
105,2019-03-30,Gonzaga,N,Texas Tech,L 69-75,200,25,59,.424,18,33,.545,7,26,.269,12,16,.750,69,25,57,.439,16,34,.471,9,23,.391,16,19,.842,75
106,2019-03-28,Gonzaga,N,Florida State,W 72-58,200,25,62,.403,18,43,.419,7,19,.368,15,20,.750,72,24,61,.393,21,41,.512,3,20,.150,7,11,.636,58
107,2019-03-23,Gonzaga,N,Baylor,W 83-71,200,31,57,.544,24,37,.649,7,20,.350,14,21,.667,83,25,60,.417,21,39,.538,4,21,.190,17,22,.773,71
108,2019-03-21,Gonzaga,N,Fairl. Dickinson,W 87-49,200,34,64,.531,25,43,.581,9,21,.429,10,16,.625,87,15,50,.300,9,29,.310,6,21,.286,13,23,.565,49
109,2019-03-12,Gonzaga,N,Saint Mary's,L 47-60,200,18,48,.375,16,31,.516,2,17,.118,9,12,.750,47,23,51,.451,19,37,.514,4,14,.286,10,11,.909,60
110,2019-03-11,Gonzaga,N,Pepperdine,W 100-74,200,37,62,.597,26,39,.667,11,23,.478,15,22,.682,100,29,65,.446,20,41,.488,9,24,.375,7,9,.778,74
111,2019-03-02,Gonzaga,@,Saint Mary's,W 69-55,200,28,53,.528,26,39,.667,2,14,.143,11,12,.917,69,23,57,.404,18,42,.429,5,15,.333,4,7,.571,55
112,2019-02-28,Gonzaga,@,Pacific,W 86-66,200,33,55,.600,28,41,.683,5,14,.357,15,18,.833,86,23,62,.371,11,38,.289,12,24,.500,8,10,.800,66
113,2019-02-23,Gonzaga,,BYU,W 102-68,200,36,66,.545,27,46,.587,9,20,.450,21,27,.778,102,26,62,.419,18,41,.439,8,21,.381,8,13,.615,68
114,2019-02-21,Gonzaga,,Pepperdine,W 92-64,200,37,59,.627,29,38,.763,8,21,.381,10,14,.714,92,26,68,.382,19,45,.422,7,23,.304,5,8,.625,64
115,2019-02-16,Gonzaga,@,San Diego,W 79-67,200,32,55,.582,29,41,.707,3,14,.214,12,14,.857,79,23,58,.397,14,32,.438,9,26,.346,12,15,.800,67
116,2019-02-14,Gonzaga,@,Loyola Marymount,W 73-60,200,23,50,.460,17,31,.548,6,19,.316,21,22,.955,73,25,66,.379,24,52,.462,1,14,.071,9,16,.563,60
117,2019-02-09,Gonzaga,,Saint Mary's,W 94-46,200,35,60,.583,27,42,.643,8,18,.444,16,20,.800,94,15,58,.259,14,45,.311,1,13,.077,15,19,.789,46
118,2019-02-07,Gonzaga,,San Francisco,W 92-62,200,32,64,.500,26,49,.531,6,15,.400,22,27,.815,92,26,67,.388,21,51,.412,5,16,.313,5,12,.417,62
119,2019-02-02,Gonzaga,,San Diego,W 85-69,200,29,54,.537,23,40,.575,6,14,.429,21,28,.750,85,24,52,.462,14,29,.483,10,23,.435,11,16,.688,69
120,2019-01-31,Gonzaga,@,BYU,W 93-63,200,37,63,.587,27,43,.628,10,20,.500,9,14,.643,93,24,65,.369,18,44,.409,6,21,.286,9,12,.750,63
121,2019-01-24,Gonzaga,@,Santa Clara,W 98-39,200,36,70,.514,26,43,.605,10,27,.370,16,19,.842,98,13,48,.271,10,30,.333,3,18,.167,10,15,.667,39
122,2019-01-19,Gonzaga,@,Portland,W 89-66,200,33,66,.500,22,35,.629,11,31,.355,12,15,.800,89,22,46,.478,15,23,.652,7,23,.304,15,22,.682,66
123,2019-01-17,Gonzaga,,Loyola Marymount,W 73-55,200,28,55,.509,21,32,.656,7,23,.304,10,14,.714,73,21,55,.382,16,46,.348,5,9,.556,8,11,.727,55
124,2019-01-12,Gonzaga,@,San Francisco,W 96-83,200,36,69,.522,27,49,.551,9,20,.450,15,21,.714,96,28,69,.406,20,44,.455,8,25,.320,19,25,.760,83
125,2019-01-10,Gonzaga,,Pacific,W 67-36,200,23,53,.434,17,29,.586,6,24,.250,15,19,.789,67,12,45,.267,8,30,.267,4,15,.267,8,13,.615,36
126,2019-01-05,Gonzaga,,Santa Clara,W 91-48,200,32,62,.516,27,43,.628,5,19,.263,22,31,.710,91,17,51,.333,13,34,.382,4,17,.235,10,22,.455,48
127,2018-12-31,Gonzaga,,Cal St Bakersfield,W 89-54,200,30,58,.517,20,32,.625,10,26,.385,19,28,.679,89,22,60,.367,19,41,.463,3,19,.158,7,10,.700,54
128,2018-12-28,Gonzaga,,North Alabama,W 96-51,200,34,63,.540,25,39,.641,9,24,.375,19,24,.792,96,18,55,.327,14,36,.389,4,19,.211,11,20,.550,51
129,2018-12-21,Gonzaga,,Denver,W 101-40,200,39,57,.684,29,34,.853,10,23,.435,13,16,.813,101,16,65,.246,14,47,.298,2,18,.111,6,10,.600,40
130,2018-12-18,Gonzaga,,UT Arlington,W 89-55,200,31,59,.525,25,35,.714,6,24,.250,21,25,.840,89,19,71,.268,11,37,.297,8,34,.235,9,11,.818,55
131,2018-12-15,Gonzaga,@,UNC,L 90-103,200,32,63,.508,24,41,.585,8,22,.364,18,23,.783,90,35,64,.547,22,39,.564,13,25,.520,20,25,.800,103
132,2018-12-09,Gonzaga,N,Tennessee,L 73-76,200,27,59,.458,20,41,.488,7,18,.389,12,19,.632,73,29,72,.403,17,43,.395,12,29,.414,6,10,.600,76
133,2018-12-05,Gonzaga,,Washington,W 81-79,200,27,63,.429,19,43,.442,8,20,.400,19,19,1.000,81,28,59,.475,19,32,.594,9,27,.333,14,15,.933,79
134,2018-12-01,Gonzaga,@,Creighton,W 103-92,200,35,67,.522,24,38,.632,11,29,.379,22,27,.815,103,36,74,.486,22,40,.550,14,34,.412,6,10,.600,92
135,2018-11-26,Gonzaga,,North Dakota St.,W 102-60,200,37,58,.638,22,30,.733,15,28,.536,13,19,.684,102,23,65,.354,19,38,.500,4,27,.148,10,17,.588,60
136,2018-11-21,Gonzaga,N,Duke,W 89-87,199,34,65,.523,24,46,.522,10,19,.526,11,19,.579,89,31,72,.431,26,59,.441,5,13,.385,20,26,.769,87
137,2018-11-20,Gonzaga,N,Arizona,W 91-74,200,34,64,.531,25,35,.714,9,29,.310,14,21,.667,91,21,51,.412,14,28,.500,7,23,.304,25,30,.833,74
138,2018-11-19,Gonzaga,N,Illinois,W 84-78,200,27,51,.529,20,32,.625,7,19,.368,23,35,.657,84,27,70,.386,17,39,.436,10,31,.323,14,19,.737,78
139,2018-11-15,Gonzaga,,Texas A&M,W 94-71,200,32,65,.492,25,44,.568,7,21,.333,23,32,.719,94,27,65,.415,22,47,.468,5,18,.278,12,19,.632,71
140,2018-11-10,Gonzaga,,Texas Southern,W 104-67,200,37,71,.521,29,46,.630,8,25,.320,22,25,.880,104,24,70,.343,17,44,.386,7,26,.269,12,18,.667,67
141,2018-11-06,Gonzaga,,Idaho State,W 120-79,200,41,70,.586,33,46,.717,8,24,.333,30,37,.811,120,32,70,.457,26,52,.500,6,18,.333,9,13,.692,79
142,2018-03-22,Gonzaga,N,Florida State,L 60-75,200,20,59,.339,15,39,.385,5,20,.250,15,24,.625,60,27,58,.466,21,38,.553,6,20,.300,15,22,.682,75
143,2018-03-17,Gonzaga,N,Ohio State,W 90-84,200,31,58,.534,22,36,.611,9,22,.409,19,31,.613,90,30,66,.455,19,40,.475,11,26,.423,13,16,.813,84
144,2018-03-15,Gonzaga,N,UNC Greensboro,W 68-64,200,25,59,.424,20,36,.556,5,23,.217,13,25,.520,68,28,67,.418,25,45,.556,3,22,.136,5,10,.500,64
145,2018-03-06,Gonzaga,N,BYU,W 74-54,200,29,62,.468,19,39,.487,10,23,.435,6,7,.857,74,22,62,.355,16,43,.372,6,19,.316,4,5,.800,54
146,2018-03-05,Gonzaga,N,San Francisco,W 88-60,200,32,60,.533,20,34,.588,12,26,.462,12,15,.800,88,22,60,.367,17,38,.447,5,22,.227,11,15,.733,60
147,2018-03-03,Gonzaga,N,Loyola Marymount,W 83-69,200,30,49,.612,18,29,.621,12,20,.600,11,22,.500,83,24,60,.400,13,39,.333,11,21,.524,10,14,.714,69
148,2018-02-24,Gonzaga,@,BYU,W 79-65,200,31,56,.554,23,32,.719,8,24,.333,9,11,.818,79,22,57,.386,16,37,.432,6,20,.300,15,22,.682,65
149,2018-02-22,Gonzaga,@,San Diego,W 77-72,200,24,55,.436,16,38,.421,8,17,.471,21,25,.840,77,24,58,.414,17,37,.459,7,21,.333,17,20,.850,72
150,2018-02-17,Gonzaga,,Pepperdine,W 81-67,200,30,58,.517,17,35,.486,13,23,.565,8,15,.533,81,24,58,.414,16,39,.410,8,19,.421,11,17,.647,67
151,2018-02-15,Gonzaga,,Loyola Marymount,W 76-46,200,26,51,.510,19,27,.704,7,24,.292,17,26,.654,76,16,49,.327,13,31,.419,3,18,.167,11,15,.733,46
152,2018-02-10,Gonzaga,@,Saint Mary's,W 78-65,200,32,68,.471,25,47,.532,7,21,.333,7,9,.778,78,22,53,.415,17,33,.515,5,20,.250,16,21,.762,65
153,2018-02-08,Gonzaga,@,Pacific,W 71-61,200,23,58,.397,19,36,.528,4,22,.182,21,25,.840,71,20,56,.357,15,44,.341,5,12,.417,16,24,.667,61
154,2018-02-03,Gonzaga,,BYU,W 68-60,200,27,62,.435,21,40,.525,6,22,.273,8,12,.667,68,25,56,.446,22,36,.611,3,20,.150,7,9,.778,60
155,2018-02-01,Gonzaga,,San Diego,W 69-59,200,25,61,.410,19,45,.422,6,16,.375,13,20,.650,69,20,61,.328,11,33,.333,9,28,.321,10,11,.909,59
156,2018-01-27,Gonzaga,,San Francisco,W 82-73,200,28,56,.500,21,34,.618,7,22,.318,19,23,.826,82,28,55,.509,19,37,.514,9,18,.500,8,11,.727,73
157,2018-01-25,Gonzaga,@,Portland,W 95-79,200,35,64,.547,24,36,.667,11,28,.393,14,24,.583,95,22,50,.440,15,32,.469,7,18,.389,28,34,.824,79
158,2018-01-20,Gonzaga,@,Santa Clara,W 75-60,200,29,57,.509,23,42,.548,6,15,.400,11,15,.733,75,21,51,.412,16,36,.444,5,15,.333,13,18,.722,60
159,2018-01-18,Gonzaga,,Saint Mary's,L 71-74,200,29,61,.475,23,39,.590,6,22,.273,7,9,.778,71,30,53,.566,22,40,.550,8,13,.615,6,12,.500,74
160,2018-01-13,Gonzaga,@,San Francisco,W 75-65,200,28,53,.528,21,34,.618,7,19,.368,12,17,.706,75,22,57,.386,10,29,.345,12,28,.429,9,19,.474,65
161,2018-01-11,Gonzaga,,Portland,W 103-57,200,41,78,.526,28,43,.651,13,35,.371,8,13,.615,103,18,60,.300,11,37,.297,7,23,.304,14,17,.824,57
162,2018-01-06,Gonzaga,@,Loyola Marymount,W 85-66,200,34,61,.557,26,41,.634,8,20,.400,9,14,.643,85,26,65,.400,17,42,.405,9,23,.391,5,7,.714,66
163,2018-01-04,Gonzaga,@,Pepperdine,W 89-59,200,35,65,.538,26,39,.667,9,26,.346,10,16,.625,89,26,58,.448,20,40,.500,6,18,.333,1,4,.250,59
164,2017-12-30,Gonzaga,,Santa Clara,W 101-52,200,36,66,.545,23,33,.697,13,33,.394,16,21,.762,101,17,45,.378,12,26,.462,5,19,.263,13,17,.765,52
165,2017-12-28,Gonzaga,,Pacific,W 81-48,200,30,66,.455,19,32,.594,11,34,.324,10,14,.714,81,19,57,.333,16,45,.356,3,12,.250,7,11,.636,48
166,2017-12-21,Gonzaga,@,San Diego State,L 70-72,200,25,59,.424,16,30,.533,9,29,.310,11,17,.647,70,22,61,.361,15,38,.395,7,23,.304,21,26,.808,72
167,2017-12-18,Gonzaga,,IUPUI,W 101-71,200,34,50,.680,26,32,.813,8,18,.444,25,29,.862,101,25,64,.391,20,42,.476,5,22,.227,16,21,.762,71
168,2017-12-16,Gonzaga,,North Dakota,W 89-83 (OT),225,32,72,.444,25,49,.510,7,23,.304,18,23,.783,89,30,58,.517,21,35,.600,9,23,.391,14,19,.737,83
169,2017-12-10,Gonzaga,@,Washington,W 97-70,200,33,65,.508,23,37,.622,10,28,.357,21,26,.808,97,26,55,.473,19,36,.528,7,19,.368,11,19,.579,70
170,2017-12-05,Gonzaga,N,Villanova,L 72-88,200,25,52,.481,19,30,.633,6,22,.273,16,21,.762,72,30,58,.517,20,37,.541,10,21,.476,18,27,.667,88
171,2017-12-01,Gonzaga,,Creighton,W 91-74,200,31,57,.544,21,32,.656,10,25,.400,19,25,.760,91,29,60,.483,17,35,.486,12,25,.480,4,8,.500,74
172,2017-11-29,Gonzaga,,Incarnate Word,W 103-68,200,37,68,.544,25,40,.625,12,28,.429,17,24,.708,103,25,57,.439,16,39,.410,9,18,.500,9,11,.818,68
173,2017-11-26,Gonzaga,N,Texas,W 76-71 (OT),225,26,57,.456,15,30,.500,11,27,.407,13,21,.619,76,26,67,.388,18,45,.400,8,22,.364,11,15,.733,71
174,2017-11-24,Gonzaga,N,Florida,L 105-111 (2OT),250,38,79,.481,28,48,.583,10,31,.323,19,25,.760,105,33,72,.458,16,36,.444,17,36,.472,28,35,.800,111
175,2017-11-23,Gonzaga,N,Ohio State,W 86-59,197,31,53,.585,19,28,.679,12,25,.480,12,18,.667,86,19,55,.345,13,35,.371,6,20,.300,15,22,.682,59
176,2017-11-18,Gonzaga,,Utah State,W 79-66,200,28,64,.438,23,46,.500,5,18,.278,18,20,.900,79,23,59,.390,12,32,.375,11,27,.407,9,13,.692,66
177,2017-11-14,Gonzaga,,Howard,W 106-69,200,40,70,.571,26,35,.743,14,35,.400,12,21,.571,106,21,68,.309,13,43,.302,8,25,.320,19,23,.826,69
178,2017-11-10,Gonzaga,,Texas Southern,W 97-69,200,35,72,.486,24,47,.511,11,25,.440,16,22,.727,97,26,72,.361,22,51,.431,4,21,.190,13,23,.565,69
179,2017-04-03,Gonzaga,N,UNC,L 65-71,200,20,59,.339,12,40,.300,8,19,.421,17,26,.654,65,26,73,.356,22,46,.478,4,27,.148,15,26,.577,71
180,2017-04-01,Gonzaga,N,South Carolina,W 77-73,200,29,60,.483,20,41,.488,9,19,.474,10,13,.769,77,25,66,.379,18,46,.391,7,20,.350,16,22,.727,73
181,2017-03-25,Gonzaga,N,Xavier,W 83-59,200,29,61,.475,17,37,.459,12,24,.500,13,25,.520,83,22,62,.355,20,46,.435,2,16,.125,13,22,.591,59
182,2017-03-23,Gonzaga,N,West Virginia,W 61-58,200,18,44,.409,14,34,.412,4,10,.400,21,32,.656,61,16,60,.267,11,37,.297,5,23,.217,21,29,.724,58
183,2017-03-18,Gonzaga,N,Northwestern,W 79-73,200,26,59,.441,22,43,.512,4,16,.250,23,36,.639,79,27,66,.409,19,42,.452,8,24,.333,11,13,.846,73
184,2017-03-16,Gonzaga,N,S Dakota St.,W 66-46,200,25,63,.397,17,33,.515,8,30,.267,8,18,.444,66,18,58,.310,13,38,.342,5,20,.250,5,11,.455,46
185,2017-03-07,Gonzaga,N,Saint Mary's,W 74-56,200,27,54,.500,23,47,.489,4,7,.571,16,20,.800,74,21,57,.368,13,40,.325,8,17,.471,6,7,.857,56
186,2017-03-06,Gonzaga,N,Santa Clara,W 77-68,200,29,52,.558,26,42,.619,3,10,.300,16,20,.800,77,26,63,.413,17,38,.447,9,25,.360,7,11,.636,68
187,2017-03-04,Gonzaga,N,Pacific,W 82-50,200,28,51,.549,23,37,.622,5,14,.357,21,25,.840,82,18,59,.305,15,48,.313,3,11,.273,11,17,.647,50
188,2017-02-25,Gonzaga,,BYU,L 71-79,200,26,57,.456,23,41,.561,3,16,.188,16,29,.552,71,28,62,.452,19,38,.500,9,24,.375,14,21,.667,79
189,2017-02-23,Gonzaga,@,San Diego,W 96-38,200,37,56,.661,24,31,.774,13,25,.520,9,17,.529,96,14,58,.241,8,28,.286,6,30,.200,4,8,.500,38
190,2017-02-18,Gonzaga,,Pacific,W 82-61,200,26,56,.464,22,40,.550,4,16,.250,26,30,.867,82,23,68,.338,18,51,.353,5,17,.294,10,18,.556,61
191,2017-02-16,Gonzaga,,San Francisco,W 96-61,200,32,63,.508,22,39,.564,10,24,.417,22,30,.733,96,22,62,.355,15,38,.395,7,24,.292,10,14,.714,61
192,2017-02-11,Gonzaga,@,Saint Mary's,W 74-64,200,26,47,.553,23,39,.590,3,8,.375,19,27,.704,74,24,59,.407,20,44,.455,4,15,.267,12,16,.750,64
193,2017-02-09,Gonzaga,@,Loyola Marymount,W 90-60,200,26,48,.542,22,39,.564,4,9,.444,34,44,.773,90,24,61,.393,16,42,.381,8,19,.421,4,8,.500,60
194,2017-02-04,Gonzaga,,Santa Clara,W 90-55,200,31,51,.608,23,35,.657,8,16,.500,20,30,.667,90,19,48,.396,14,32,.438,5,16,.313,12,18,.667,55
195,2017-02-02,Gonzaga,@,BYU,W 85-75,200,27,59,.458,20,39,.513,7,20,.350,24,34,.706,85,24,67,.358,18,45,.400,6,22,.273,21,26,.808,75
196,2017-01-28,Gonzaga,@,Pepperdine,W 96-49,200,41,70,.586,36,49,.735,5,21,.238,9,11,.818,96,19,63,.302,18,51,.353,1,12,.083,10,15,.667,49
197,2017-01-26,Gonzaga,,San Diego,W 79-43,200,34,64,.531,28,44,.636,6,20,.300,5,9,.556,79,16,50,.320,11,30,.367,5,20,.250,6,11,.545,43
198,2017-01-23,Gonzaga,@,Portland,W 83-64,200,31,60,.517,23,36,.639,8,24,.333,13,18,.722,83,23,64,.359,15,44,.341,8,20,.400,10,15,.667,64
199,2017-01-21,Gonzaga,,Portland,W 73-52,200,24,53,.453,17,31,.548,7,22,.318,18,22,.818,73,19,59,.322,16,47,.340,3,12,.250,11,18,.611,52
200,2017-01-19,Gonzaga,@,Santa Clara,W 88-57,200,30,58,.517,24,39,.615,6,19,.316,22,28,.786,88,19,52,.365,10,27,.370,9,25,.360,10,14,.714,57
201,2017-01-14,Gonzaga,,Saint Mary's,W 79-56,200,33,51,.647,26,38,.684,7,13,.538,6,8,.750,79,23,58,.397,17,42,.405,6,16,.375,4,5,.800,56
202,2017-01-12,Gonzaga,,Loyola Marymount,W 93-55,200,35,66,.530,25,48,.521,10,18,.556,13,21,.619,93,20,58,.345,13,39,.333,7,19,.368,8,13,.615,55
203,2017-01-05,Gonzaga,@,San Francisco,W 95-80,200,36,59,.610,30,39,.769,6,20,.300,17,20,.850,95,30,64,.469,23,35,.657,7,29,.241,13,21,.619,80
204,2016-12-31,Gonzaga,@,Pacific,W 81-61,200,30,58,.517,18,31,.581,12,27,.444,9,11,.818,81,26,57,.456,21,47,.447,5,10,.500,4,11,.364,61
205,2016-12-29,Gonzaga,,Pepperdine,W 92-62,200,33,69,.478,23,42,.548,10,27,.370,16,24,.667,92,25,56,.446,19,42,.452,6,14,.429,6,7,.857,62
206,2016-12-21,Gonzaga,,South Dakota,W 102-65,200,39,73,.534,27,45,.600,12,28,.429,12,16,.750,102,25,69,.362,21,48,.438,4,21,.190,11,15,.733,65
207,2016-12-18,Gonzaga,@,Tennessee,W 86-76,200,25,46,.543,16,26,.615,9,20,.450,27,33,.818,86,21,69,.304,11,40,.275,10,29,.345,24,33,.727,76
208,2016-12-10,Gonzaga,,Akron,W 61-43,200,20,50,.400,16,35,.457,4,15,.267,17,20,.850,61,16,60,.267,11,35,.314,5,25,.200,6,14,.429,43
209,2016-12-07,Gonzaga,,Washington,W 98-71,200,35,65,.538,27,49,.551,8,16,.500,20,28,.714,98,24,79,.304,19,59,.322,5,20,.250,18,28,.643,71
210,2016-12-03,Gonzaga,N,Arizona,W 69-62,200,24,54,.444,17,33,.515,7,21,.333,14,22,.636,69,22,57,.386,21,49,.429,1,8,.125,17,26,.654,62
211,2016-12-01,Gonzaga,,Miss Val St,W 97-63,200,36,71,.507,24,39,.615,12,32,.375,13,19,.684,97,27,63,.429,24,45,.533,3,18,.167,6,12,.500,63
212,2016-11-27,Gonzaga,N,Iowa State,W 73-71,200,27,55,.491,14,30,.467,13,25,.520,6,12,.500,73,29,66,.439,21,42,.500,8,24,.333,5,8,.625,71
213,2016-11-25,Gonzaga,N,Florida,W 77-72,200,30,58,.517,23,42,.548,7,16,.438,10,14,.714,77,24,65,.369,22,46,.478,2,19,.105,22,24,.917,72
214,2016-11-24,Gonzaga,N,Quinnipiac,W 82-62,200,29,66,.439,23,44,.523,6,22,.273,18,21,.857,82,24,59,.407,18,40,.450,6,19,.316,8,16,.500,62
215,2016-11-18,Gonzaga,,Bryant,W 109-70,200,34,61,.557,27,42,.643,7,19,.368,34,45,.756,109,26,61,.426,19,46,.413,7,15,.467,11,19,.579,70
216,2016-11-14,Gonzaga,,San Diego State,W 69-48,200,26,66,.394,18,42,.429,8,24,.333,9,14,.643,69,16,56,.286,11,35,.314,5,21,.238,11,14,.786,48
217,2016-11-11,Gonzaga,,Utah Valley,W 92-69,200,35,67,.522,28,50,.560,7,17,.412,15,18,.833,92,24,66,.364,15,41,.366,9,25,.360,12,20,.600,69
218,2016-03-25,Gonzaga,N,Syracuse,L 60-63,200,24,55,.436,16,34,.471,8,21,.381,4,5,.800,60,22,61,.361,17,46,.370,5,15,.333,14,16,.875,63
219,2016-03-19,Gonzaga,N,Utah,W 82-59,200,34,61,.557,25,42,.595,9,19,.474,5,6,.833,82,22,52,.423,15,37,.405,7,15,.467,8,8,1.000,59
220,2016-03-17,Gonzaga,N,Seton Hall,W 68-52,200,24,56,.429,18,39,.462,6,17,.353,14,21,.667,68,20,62,.323,16,41,.390,4,21,.190,8,21,.381,52
221,2016-03-08,Gonzaga,N,Saint Mary's,W 85-75,200,29,47,.617,23,34,.676,6,13,.462,21,22,.955,85,25,54,.463,13,29,.448,12,25,.480,13,16,.813,75
222,2016-03-07,Gonzaga,N,BYU,W 88-84,200,28,57,.491,16,29,.552,12,28,.429,20,25,.800,88,31,70,.443,21,44,.477,10,26,.385,12,15,.800,84
223,2016-03-05,Gonzaga,N,Portland,W 92-67,200,31,61,.508,21,37,.568,10,24,.417,20,24,.833,92,23,57,.404,16,34,.471,7,23,.304,14,20,.700,67
224,2016-02-27,Gonzaga,@,BYU,W 71-68,200,24,51,.471,18,32,.563,6,19,.316,17,24,.708,71,22,67,.328,12,35,.343,10,32,.313,14,20,.700,68
225,2016-02-25,Gonzaga,@,San Diego,W 82-60,200,28,56,.500,23,40,.575,5,16,.313,21,27,.778,82,19,58,.328,10,29,.345,9,29,.310,13,16,.813,60
226,2016-02-20,Gonzaga,,Saint Mary's,L 58-63,200,22,62,.355,17,36,.472,5,26,.192,9,14,.643,58,24,50,.480,17,33,.515,7,17,.412,8,16,.500,63
227,2016-02-18,Gonzaga,,Pacific,W 90-68,200,28,55,.509,19,36,.528,9,19,.474,25,29,.862,90,27,58,.466,21,41,.512,6,17,.353,8,14,.571,68
228,2016-02-13,Gonzaga,@,SMU,L 60-69,200,23,61,.377,13,29,.448,10,32,.313,4,7,.571,60,26,56,.464,22,46,.478,4,10,.400,13,18,.722,69
229,2016-02-11,Gonzaga,@,Portland,W 92-66,200,31,58,.534,16,32,.500,15,26,.577,15,21,.714,92,27,59,.458,24,37,.649,3,22,.136,9,15,.600,66
230,2016-02-06,Gonzaga,@,Pepperdine,W 69-66,200,22,51,.431,18,32,.563,4,19,.211,21,23,.913,69,24,55,.436,17,38,.447,7,17,.412,11,17,.647,66
231,2016-02-04,Gonzaga,@,Loyola Marymount,W 92-63,200,37,65,.569,31,44,.705,6,21,.286,12,14,.857,92,24,59,.407,22,44,.500,2,15,.133,13,15,.867,63
232,2016-01-30,Gonzaga,,San Francisco,W 86-48,200,30,69,.435,15,32,.469,15,37,.405,11,18,.611,86,18,59,.305,14,34,.412,4,25,.160,8,15,.533,48
233,2016-01-28,Gonzaga,,Santa Clara,W 84-67,200,23,51,.451,10,25,.400,13,26,.500,25,30,.833,84,23,63,.365,18,42,.429,5,21,.238,16,26,.615,67
234,2016-01-23,Gonzaga,@,Pacific,W 71-61,200,23,51,.451,18,34,.529,5,17,.294,20,32,.625,71,19,61,.311,12,38,.316,7,23,.304,16,23,.696,61
235,2016-01-21,Gonzaga,@,Saint Mary's,L 67-70,200,29,49,.592,23,34,.676,6,15,.400,3,5,.600,67,25,50,.500,19,34,.559,6,16,.375,14,16,.875,70
236,2016-01-16,Gonzaga,,San Diego,W 88-52,200,34,60,.567,23,42,.548,11,18,.611,9,10,.900,88,21,67,.313,16,41,.390,5,26,.192,5,7,.714,52
237,2016-01-14,Gonzaga,,BYU,L 68-69,200,21,57,.368,15,37,.405,6,20,.300,20,24,.833,68,27,65,.415,24,48,.500,3,17,.176,12,14,.857,69
238,2016-01-09,Gonzaga,,Portland,W 85-74,200,27,64,.422,20,45,.444,7,19,.368,24,29,.828,85,26,59,.441,22,39,.564,4,20,.200,18,21,.857,74
239,2016-01-02,Gonzaga,@,San Francisco,W 102-94 (OT),225,37,68,.544,32,49,.653,5,19,.263,23,32,.719,102,34,76,.447,20,45,.444,14,31,.452,12,16,.750,94
240,2015-12-31,Gonzaga,@,Santa Clara,W 79-77,200,29,51,.569,24,39,.615,5,12,.417,16,23,.696,79,25,58,.431,13,34,.382,12,24,.500,15,20,.750,77
241,2015-12-23,Gonzaga,,Loyola Marymount,W 85-62,200,27,45,.600,17,27,.630,10,18,.556,21,23,.913,85,24,60,.400,19,40,.475,5,20,.250,9,14,.643,62
242,2015-12-21,Gonzaga,,Pepperdine,W 99-73,200,32,58,.552,16,32,.500,16,26,.615,19,21,.905,99,26,57,.456,20,39,.513,6,18,.333,15,23,.652,73
243,2015-12-19,Gonzaga,N,Tennessee,W 86-79,200,29,63,.460,25,45,.556,4,18,.222,24,33,.727,86,29,66,.439,19,45,.422,10,21,.476,11,16,.688,79
244,2015-12-14,Gonzaga,,Saint Martin's,W 86-50,200,33,64,.516,24,44,.545,9,20,.450,11,14,.786,86,18,54,.333,14,29,.483,4,25,.160,10,16,.625,50
245,2015-12-12,Gonzaga,,UCLA,L 66-71,200,25,61,.410,19,35,.543,6,26,.231,10,13,.769,66,28,60,.467,23,44,.523,5,16,.313,10,18,.556,71
246,2015-12-08,Gonzaga,,Montana,W 61-58,200,22,55,.400,18,40,.450,4,15,.267,13,17,.765,61,22,61,.361,16,40,.400,6,21,.286,8,11,.727,58
247,2015-12-05,Gonzaga,,Arizona,L 63-68,200,27,61,.443,24,48,.500,3,13,.231,6,8,.750,63,27,65,.415,22,50,.440,5,15,.333,9,19,.474,68
248,2015-12-02,Gonzaga,@,Washington St.,W 69-60,200,27,63,.429,20,42,.476,7,21,.333,8,11,.727,69,25,62,.403,23,52,.442,2,10,.200,8,10,.800,60
249,2015-11-27,Gonzaga,N,UConn,W 73-70,200,28,62,.452,18,38,.474,10,24,.417,7,11,.636,73,26,62,.419,25,50,.500,1,12,.083,17,20,.850,70
250,2015-11-26,Gonzaga,N,Texas A&M,L 61-62,200,24,51,.471,15,30,.500,9,21,.429,4,11,.364,61,21,47,.447,14,33,.424,7,14,.500,13,16,.813,62
251,2015-11-25,Gonzaga,N,Washington,W 80-64,200,24,48,.500,22,40,.550,2,8,.250,30,44,.682,80,19,74,.257,15,54,.278,4,20,.200,22,30,.733,64
252,2015-11-21,Gonzaga,,Mt. St. Mary's,W 101-56,200,39,66,.591,28,44,.636,11,22,.500,12,17,.706,101,21,60,.350,18,39,.462,3,21,.143,11,15,.733,56
253,2015-11-18,Gonzaga,,Northern Ariz.,W 91-52,200,36,68,.529,30,45,.667,6,23,.261,13,20,.650,91,19,63,.302,16,46,.348,3,17,.176,11,17,.647,52
254,2015-03-29,Gonzaga,N,Duke,L 52-66,200,22,50,.440,20,40,.500,2,10,.200,6,9,.667,52,21,56,.375,13,37,.351,8,19,.421,16,19,.842,66
255,2015-03-27,Gonzaga,N,UCLA,W 74-62,200,27,67,.403,24,48,.500,3,19,.158,17,23,.739,74,26,67,.388,23,54,.426,3,13,.231,7,11,.636,62
256,2015-03-22,Gonzaga,N,Iowa,W 87-68,200,32,52,.615,22,36,.611,10,16,.625,13,21,.619,87,28,60,.467,23,45,.511,5,15,.333,7,10,.700,68
257,2015-03-20,Gonzaga,N,North Dakota St.,W 86-76,200,30,58,.517,23,36,.639,7,22,.318,19,28,.679,86,29,54,.537,19,33,.576,10,21,.476,8,12,.667,76
258,2015-03-10,Gonzaga,N,BYU,W 91-75,200,29,54,.537,21,42,.500,8,12,.667,25,37,.676,91,27,67,.403,21,52,.404,6,15,.400,15,20,.750,75
259,2015-03-09,Gonzaga,N,Pepperdine,W 79-61,200,31,59,.525,23,42,.548,8,17,.471,9,19,.474,79,25,58,.431,21,43,.488,4,15,.267,7,12,.583,61
260,2015-03-07,Gonzaga,N,San Francisco,W 81-72,200,29,55,.527,22,34,.647,7,21,.333,16,24,.667,81,24,65,.369,18,43,.419,6,22,.273,18,23,.783,72
261,2015-02-28,Gonzaga,,BYU,L 70-73,200,25,57,.439,19,41,.463,6,16,.375,14,21,.667,70,25,59,.424,18,43,.419,7,16,.438,16,29,.552,73
262,2015-02-26,Gonzaga,,San Diego,W 59-39,201,24,47,.511,21,35,.600,3,12,.250,8,15,.533,59,16,54,.296,15,43,.349,1,11,.091,6,11,.545,39
263,2015-02-21,Gonzaga,@,Saint Mary's,W 70-60,200,24,51,.471,16,37,.432,8,14,.571,14,19,.737,70,23,56,.411,14,36,.389,9,20,.450,5,7,.714,60
264,2015-02-19,Gonzaga,@,Pacific,W 86-74,200,30,50,.600,20,32,.625,10,18,.556,16,17,.941,86,25,57,.439,14,38,.368,11,19,.579,13,19,.684,74
265,2015-02-14,Gonzaga,,Pepperdine,W 56-48,200,20,48,.417,15,30,.500,5,18,.278,11,12,.917,56,22,52,.423,22,42,.524,0,10,.000,4,7,.571,48
266,2015-02-12,Gonzaga,,Loyola Marymount,W 80-51,200,26,53,.491,18,32,.563,8,21,.381,20,35,.571,80,15,51,.294,9,32,.281,6,19,.316,15,24,.625,51
267,2015-02-07,Gonzaga,@,San Francisco,W 81-70,200,26,52,.500,20,35,.571,6,17,.353,23,30,.767,81,26,52,.500,17,37,.459,9,15,.600,9,13,.692,70
268,2015-02-05,Gonzaga,@,Santa Clara,W 77-63,200,29,42,.690,24,36,.667,5,6,.833,14,22,.636,77,25,59,.424,16,41,.390,9,18,.500,4,9,.444,63
269,2015-01-31,Gonzaga,,Memphis,W 82-64,199,26,47,.553,18,31,.581,8,16,.500,22,32,.688,82,26,74,.351,22,58,.379,4,16,.250,8,14,.571,64
270,2015-01-29,Gonzaga,,Portland,W 64-46,200,24,59,.407,19,37,.514,5,22,.227,11,17,.647,64,18,61,.295,13,46,.283,5,15,.333,5,9,.556,46
271,2015-01-24,Gonzaga,,Pacific,W 91-60,200,33,55,.600,22,30,.733,11,25,.440,14,20,.700,91,18,54,.333,13,32,.406,5,22,.227,19,27,.704,60
272,2015-01-22,Gonzaga,,Saint Mary's,W 68-47,200,27,51,.529,21,33,.636,6,18,.333,8,13,.615,68,18,50,.360,16,35,.457,2,15,.133,9,15,.600,47
273,2015-01-17,Gonzaga,@,Loyola Marymount,W 72-55,200,25,48,.521,15,26,.577,10,22,.455,12,16,.750,72,17,58,.293,12,37,.324,5,21,.238,16,20,.800,55
274,2015-01-15,Gonzaga,@,Pepperdine,W 78-76,200,29,51,.569,23,39,.590,6,12,.500,14,33,.424,78,28,55,.509,24,43,.558,4,12,.333,16,22,.727,76
275,2015-01-10,Gonzaga,,Santa Clara,W 79-57,200,31,58,.534,26,47,.553,5,11,.455,12,15,.800,79,19,54,.352,10,34,.294,9,20,.450,10,14,.714,57
276,2015-01-08,Gonzaga,,San Francisco,W 88-57,200,32,61,.525,20,33,.606,12,28,.429,12,18,.667,88,20,49,.408,13,27,.481,7,22,.318,10,16,.625,57
277,2015-01-03,Gonzaga,@,Portland,W 87-75,200,29,51,.569,23,35,.657,6,16,.375,23,28,.821,87,28,60,.467,22,45,.489,6,15,.400,13,21,.619,75
278,2014-12-29,Gonzaga,@,San Diego,W 60-48,200,22,52,.423,17,37,.459,5,15,.333,11,16,.688,60,15,56,.268,10,34,.294,5,22,.227,13,20,.650,48
279,2014-12-27,Gonzaga,@,BYU,W 87-80,200,32,65,.492,24,46,.522,8,19,.421,15,21,.714,87,23,58,.397,16,33,.485,7,25,.280,27,31,.871,80
280,2014-12-20,Gonzaga,N,Cal Poly,W 63-50,200,21,46,.457,16,33,.485,5,13,.385,16,20,.800,63,21,53,.396,18,38,.474,3,15,.200,5,11,.455,50
281,2014-12-15,Gonzaga,,Texas Southern,W 94-54,200,35,55,.636,25,36,.694,10,19,.526,14,18,.778,94,21,59,.356,18,42,.429,3,17,.176,9,17,.529,54
282,2014-12-13,Gonzaga,@,UCLA,W 87-74,200,31,53,.585,22,34,.647,9,19,.474,16,19,.842,87,25,60,.417,16,41,.390,9,19,.474,15,22,.682,74
283,2014-12-10,Gonzaga,N,Washington St.,W 81-66,200,35,65,.538,31,54,.574,4,11,.364,7,10,.700,81,25,48,.521,19,36,.528,6,12,.500,10,14,.714,66
284,2014-12-06,Gonzaga,@,Arizona,L 63-66 (OT),225,23,58,.397,19,41,.463,4,17,.235,13,19,.684,63,23,52,.442,17,35,.486,6,17,.353,14,22,.636,66
285,2014-12-02,Gonzaga,,Southeastern LA,W 76-57,200,30,57,.526,21,33,.636,9,24,.375,7,7,1.000,76,22,45,.489,17,30,.567,5,15,.333,8,10,.800,57
286,2014-11-28,Gonzaga,N,St. John's (NY),W 73-66,200,27,51,.529,23,37,.622,4,14,.286,15,25,.600,73,22,60,.367,14,36,.389,8,24,.333,14,23,.609,66
287,2014-11-26,Gonzaga,N,Georgia,W 88-76,200,26,52,.500,22,39,.564,4,13,.308,32,35,.914,88,25,54,.463,21,38,.553,4,16,.250,22,35,.629,76
288,2014-11-22,Gonzaga,,St. Thomas Aquinas,W 109-55,200,42,62,.677,35,45,.778,7,17,.412,18,23,.783,109,16,52,.308,9,32,.281,7,20,.350,16,25,.640,55
289,2014-11-19,Gonzaga,,St. Joseph's,W 94-42,200,37,65,.569,27,43,.628,10,22,.455,10,17,.588,94,15,58,.259,13,40,.325,2,18,.111,10,17,.588,42
290,2014-11-17,Gonzaga,,SMU,W 72-56,200,27,60,.450,17,36,.472,10,24,.417,8,20,.400,72,19,61,.311,13,45,.289,6,16,.375,12,16,.750,56
291,2014-11-14,Gonzaga,,Sacramento St.,W 104-58,200,36,66,.545,26,42,.619,10,24,.417,22,32,.688,104,20,56,.357,15,41,.366,5,15,.333,13,20,.650,58
292,2014-03-23,Gonzaga,N,Arizona,L 61-84,200,22,54,.407,16,38,.421,6,16,.375,11,13,.846,61,32,65,.492,25,47,.532,7,18,.389,13,18,.722,84
293,2014-03-21,Gonzaga,N,Oklahoma State,W 85-77,200,25,50,.500,16,32,.500,9,18,.500,26,41,.634,85,26,65,.400,23,50,.460,3,15,.200,22,37,.595,77
294,2014-03-11,Gonzaga,N,BYU,W 75-64,200,25,48,.521,19,35,.543,6,13,.462,19,30,.633,75,21,59,.356,18,46,.391,3,13,.231,19,26,.731,64
295,2014-03-10,Gonzaga,N,Saint Mary's,W 70-54,200,23,50,.460,18,36,.500,5,14,.357,19,26,.731,70,19,51,.373,17,43,.395,2,8,.250,14,25,.560,54
296,2014-03-08,Gonzaga,N,Santa Clara,W 77-75,200,24,45,.533,22,34,.647,2,11,.182,27,33,.818,77,28,56,.500,21,37,.568,7,19,.368,12,15,.800,75
297,2014-03-01,Gonzaga,@,Saint Mary's,W 75-47,200,32,57,.561,29,47,.617,3,10,.300,8,12,.667,75,12,52,.231,7,34,.206,5,18,.278,18,28,.643,47
298,2014-02-27,Gonzaga,@,Pacific,W 70-53,200,21,50,.420,14,32,.438,7,18,.389,21,32,.656,70,17,55,.309,11,36,.306,6,19,.316,13,21,.619,53
299,2014-02-22,Gonzaga,@,San Diego,L 66-69,200,27,54,.500,21,41,.512,6,13,.462,6,11,.545,66,19,47,.404,11,25,.440,8,22,.364,23,33,.697,69
300,2014-02-20,Gonzaga,@,BYU,L 65-73,200,22,54,.407,18,36,.500,4,18,.222,17,23,.739,65,25,57,.439,21,43,.488,4,14,.286,19,28,.679,73
301,2014-02-15,Gonzaga,,Loyola Marymount,W 86-67,105,29,62,.468,21,37,.568,8,25,.320,20,25,.800,86,23,52,.442,19,39,.487,4,13,.308,17,19,.895,67
302,2014-02-13,Gonzaga,,Pepperdine,W 83-68,200,31,59,.525,21,35,.600,10,24,.417,11,16,.688,83,27,58,.466,24,41,.585,3,17,.176,11,17,.647,68
303,2014-02-08,Gonzaga,@,Memphis,L 54-60,200,23,51,.451,21,35,.600,2,16,.125,6,13,.462,54,19,55,.345,15,43,.349,4,12,.333,18,27,.667,60
304,2014-02-05,Gonzaga,,Portland,W 71-66,199,20,43,.465,11,24,.458,9,19,.474,22,32,.688,71,24,56,.429,16,44,.364,8,12,.667,10,14,.714,66
305,2014-02-01,Gonzaga,@,San Francisco,W 75-65,200,19,49,.388,16,33,.485,3,16,.188,34,41,.829,75,20,58,.345,12,33,.364,8,25,.320,17,22,.773,65
306,2014-01-29,Gonzaga,@,Santa Clara,W 54-52,200,16,46,.348,11,34,.324,5,12,.417,17,19,.895,54,18,50,.360,13,32,.406,5,18,.278,11,12,.917,52
307,2014-01-25,Gonzaga,,BYU,W 84-69,200,31,54,.574,21,32,.656,10,22,.455,12,12,1.000,84,26,58,.448,24,47,.511,2,11,.182,15,21,.714,69
308,2014-01-23,Gonzaga,,San Diego,W 59-56,200,25,52,.481,18,34,.529,7,18,.389,2,4,.500,59,19,46,.413,15,32,.469,4,14,.286,14,15,.933,56
309,2014-01-18,Gonzaga,@,Loyola Marymount,W 82-72,200,33,62,.532,28,49,.571,5,13,.385,11,14,.786,82,28,66,.424,22,51,.431,6,15,.400,10,13,.769,72
310,2014-01-16,Gonzaga,@,Pepperdine,W 70-53,200,25,55,.455,20,37,.541,5,18,.278,15,24,.625,70,17,52,.327,13,36,.361,4,16,.250,15,24,.625,53
311,2014-01-09,Gonzaga,@,Portland,L 73-82,200,26,58,.448,22,43,.512,4,15,.267,17,25,.680,73,27,52,.519,19,38,.500,8,14,.571,20,26,.769,82
312,2014-01-04,Gonzaga,,Pacific,W 86-64,200,27,39,.692,17,26,.654,10,13,.769,22,39,.564,86,19,60,.317,9,35,.257,10,25,.400,16,20,.800,64
313,2014-01-02,Gonzaga,,Saint Mary's,W 73-51,201,24,49,.490,15,30,.500,9,19,.474,16,18,.889,73,15,47,.319,14,35,.400,1,12,.083,20,27,.741,51
314,2013-12-30,Gonzaga,,San Francisco,W 69-41,200,25,58,.431,17,35,.486,8,23,.348,11,20,.550,69,14,55,.255,8,34,.235,6,21,.286,7,17,.412,41
315,2013-12-28,Gonzaga,,Santa Clara,W 74-60,200,23,48,.479,18,35,.514,5,13,.385,23,31,.742,74,24,51,.471,18,33,.545,6,18,.333,6,12,.500,60
316,2013-12-21,Gonzaga,N,Kansas State,L 62-72,200,24,50,.480,17,29,.586,7,21,.333,7,15,.467,62,24,54,.444,19,36,.528,5,18,.278,19,25,.760,72
317,2013-12-14,Gonzaga,N,South Alabama,W 68-59,200,26,64,.406,24,50,.480,2,14,.143,14,21,.667,68,19,59,.322,12,42,.286,7,17,.412,14,19,.737,59
318,2013-12-10,Gonzaga,@,West Virginia,W 80-76,200,27,61,.443,20,41,.488,7,20,.350,19,23,.826,80,25,67,.373,16,40,.400,9,27,.333,17,22,.773,76
319,2013-12-07,Gonzaga,,New Mexico St.,W 80-68,200,33,68,.485,29,58,.500,4,10,.400,10,16,.625,80,25,59,.424,19,42,.452,6,17,.353,12,18,.667,68
320,2013-12-01,Gonzaga,,Coppin State,W 86-51,200,31,62,.500,19,36,.528,12,26,.462,12,21,.571,86,18,56,.321,16,38,.421,2,18,.111,13,17,.765,51
321,2013-11-27,Gonzaga,N,Arkansas,W 91-81,200,30,55,.545,18,35,.514,12,20,.600,19,27,.704,91,31,72,.431,27,51,.529,4,21,.190,15,19,.789,81
322,2013-11-26,Gonzaga,@,Chaminade,W 113-81,200,46,66,.697,33,43,.767,13,23,.565,8,11,.727,113,26,61,.426,18,36,.500,8,25,.320,21,25,.840,81
323,2013-11-25,Gonzaga,N,Dayton,L 79-84,200,26,54,.481,21,35,.600,5,19,.263,22,25,.880,79,27,59,.458,18,38,.474,9,21,.429,21,35,.600,84
324,2013-11-21,Gonzaga,,Washington St.,W 90-74,200,33,59,.559,20,36,.556,13,23,.565,11,18,.611,90,25,56,.446,16,28,.571,9,28,.321,15,21,.714,74
325,2013-11-17,Gonzaga,,Oakland,W 82-67,200,28,51,.549,17,31,.548,11,20,.550,15,18,.833,82,22,45,.489,11,25,.440,11,20,.550,12,15,.800,67
326,2013-11-11,Gonzaga,,Colorado State,W 93-61,200,34,59,.576,20,28,.714,14,31,.452,11,16,.688,93,18,56,.321,13,39,.333,5,17,.294,20,28,.714,61
327,2013-11-09,Gonzaga,,Bryant,W 100-76,200,36,67,.537,29,48,.604,7,19,.368,21,28,.750,100,27,60,.450,23,39,.590,4,21,.190,18,23,.783,76
328,2013-03-23,Gonzaga,N,Wichita State,L 70-76,200,21,59,.356,13,36,.361,8,23,.348,20,29,.690,70,25,50,.500,11,22,.500,14,28,.500,12,18,.667,76
329,2013-03-21,Gonzaga,N,Southern,W 64-58,200,23,55,.418,15,35,.429,8,20,.400,10,15,.667,64,18,46,.391,8,23,.348,10,23,.435,12,18,.667,58
330,2013-03-11,Gonzaga,N,Saint Mary's,W 65-51,200,25,48,.521,23,39,.590,2,9,.222,13,16,.813,65,20,56,.357,13,29,.448,7,27,.259,4,9,.444,51
331,2013-03-09,Gonzaga,N,Loyola Marymount,W 66-48,200,20,46,.435,15,32,.469,5,14,.357,21,31,.677,66,15,49,.306,10,29,.345,5,20,.250,13,19,.684,48
332,2013-03-02,Gonzaga,,Portland,W 81-52,200,31,63,.492,23,40,.575,8,23,.348,11,17,.647,81,17,59,.288,9,39,.231,8,20,.400,10,14,.714,52
333,2013-02-28,Gonzaga,@,BYU,W 70-65,200,22,53,.415,16,23,.696,6,30,.200,20,34,.588,70,23,63,.365,17,46,.370,6,17,.353,13,22,.591,65
334,2013-02-23,Gonzaga,,San Diego,W 81-50,200,30,55,.545,22,36,.611,8,19,.421,13,17,.765,81,15,42,.357,13,28,.464,2,14,.143,18,28,.643,50
335,2013-02-20,Gonzaga,,Santa Clara,W 85-42,200,33,58,.569,26,41,.634,7,17,.412,12,17,.706,85,16,53,.302,12,36,.333,4,17,.235,6,10,.600,42
336,2013-02-16,Gonzaga,@,San Francisco,W 71-61,200,27,58,.466,24,42,.571,3,16,.188,14,18,.778,71,21,57,.368,14,34,.412,7,23,.304,12,16,.750,61
337,2013-02-14,Gonzaga,@,Saint Mary's,W 77-60,200,24,48,.500,15,31,.484,9,17,.529,20,24,.833,77,23,58,.397,11,23,.478,12,35,.343,2,5,.400,60
338,2013-02-09,Gonzaga,,Loyola Marymount,W 74-55,200,24,47,.511,19,32,.594,5,15,.333,21,30,.700,74,17,57,.298,14,41,.341,3,16,.188,18,22,.818,55
339,2013-02-07,Gonzaga,,Pepperdine,W 82-56,200,26,58,.448,14,31,.452,12,27,.444,18,24,.750,82,17,47,.362,10,28,.357,7,19,.368,15,21,.714,56
340,2013-02-02,Gonzaga,@,San Diego,W 65-63,200,25,57,.439,21,49,.429,4,8,.500,11,16,.688,65,26,60,.433,20,39,.513,6,21,.286,5,9,.556,63
341,2013-01-31,Gonzaga,@,Loyola Marymount,W 88-43,200,31,57,.544,18,36,.500,13,21,.619,13,26,.500,88,14,56,.250,6,30,.200,8,26,.308,7,12,.583,43
342,2013-01-26,Gonzaga,,San Francisco,W 66-52,200,26,58,.448,18,38,.474,8,20,.400,6,11,.545,66,20,51,.392,11,27,.407,9,24,.375,3,8,.375,52
343,2013-01-24,Gonzaga,,BYU,W 83-63,200,29,51,.569,23,33,.697,6,18,.333,19,23,.826,83,21,59,.356,17,42,.405,4,17,.235,17,22,.773,63
344,2013-01-19,Gonzaga,@,Butler,L 63-64,200,24,51,.471,20,37,.541,4,14,.286,11,15,.733,63,22,44,.500,14,25,.560,8,19,.421,12,23,.522,64
345,2013-01-17,Gonzaga,@,Portland,W 71-49,200,27,58,.466,18,37,.486,9,21,.429,8,11,.727,71,18,44,.409,15,34,.441,3,10,.300,10,13,.769,49
346,2013-01-10,Gonzaga,,Saint Mary's,W 83-78,200,32,59,.542,28,45,.622,4,14,.286,15,18,.833,83,28,61,.459,21,34,.618,7,27,.259,15,23,.652,78
347,2013-01-05,Gonzaga,@,Santa Clara,W 81-74,200,26,47,.553,24,38,.632,2,9,.222,27,30,.900,81,25,61,.410,18,38,.474,7,23,.304,17,22,.773,74
348,2013-01-03,Gonzaga,@,Pepperdine,W 78-62,200,23,53,.434,16,34,.471,7,19,.368,25,29,.862,78,24,55,.436,22,43,.512,2,12,.167,12,16,.750,62
349,2012-12-31,Gonzaga,@,Oklahoma State,W 69-68,200,24,50,.480,18,34,.529,6,16,.375,15,18,.833,69,26,55,.473,17,32,.531,9,23,.391,7,11,.636,68
350,2012-12-28,Gonzaga,,Baylor,W 94-87,200,31,59,.525,22,41,.537,9,18,.500,23,34,.676,94,33,64,.516,23,40,.575,10,24,.417,11,13,.846,87
351,2012-12-19,Gonzaga,,Campbell,W 74-52,200,25,51,.490,22,38,.579,3,13,.231,21,25,.840,74,18,55,.327,11,41,.268,7,14,.500,9,15,.600,52
352,2012-12-15,Gonzaga,N,Kansas State,W 68-52,200,24,51,.471,21,39,.538,3,12,.250,17,20,.850,68,16,48,.333,10,30,.333,6,18,.333,14,19,.737,52
353,2012-12-08,Gonzaga,,Illinois,L 74-85,200,24,49,.490,19,31,.613,5,18,.278,21,27,.778,74,30,60,.500,19,34,.559,11,26,.423,14,17,.824,85
354,2012-12-05,Gonzaga,@,Washington St.,W 71-69,200,28,55,.509,21,39,.538,7,16,.438,8,15,.533,71,24,53,.453,14,26,.538,10,27,.370,11,18,.611,69
355,2012-12-01,Gonzaga,,Pacific,W 85-67,200,28,59,.475,22,36,.611,6,23,.261,23,28,.821,85,23,49,.469,13,30,.433,10,19,.526,11,19,.579,67
356,2012-11-29,Gonzaga,,Lewis & Clark,W 104-57,200,43,67,.642,32,47,.681,11,20,.550,7,15,.467,104,22,59,.373,14,37,.378,8,22,.364,5,7,.714,57
357,2012-11-25,Gonzaga,N,Davidson,W 81-67,200,27,49,.551,20,35,.571,7,14,.500,20,29,.690,81,21,58,.362,15,39,.385,6,19,.316,19,21,.905,67
358,2012-11-23,Gonzaga,N,Oklahoma,W 72-47,200,27,59,.458,21,37,.568,6,22,.273,12,19,.632,72,16,50,.320,11,34,.324,5,16,.313,10,15,.667,47
359,2012-11-22,Gonzaga,N,Clemson,W 57-49,200,23,47,.489,21,36,.583,2,11,.182,9,15,.600,57,18,58,.310,12,36,.333,6,22,.273,7,11,.636,49
360,2012-11-18,Gonzaga,,South Dakota,W 96-58,200,42,76,.553,34,53,.642,8,23,.348,4,15,.267,96,21,62,.339,11,34,.324,10,28,.357,6,9,.667,58
361,2012-11-12,Gonzaga,,West Virginia,W 84-50,200,26,50,.520,17,34,.500,9,16,.563,23,36,.639,84,15,55,.273,12,29,.414,3,26,.115,17,25,.680,50
362,2012-11-09,Gonzaga,,Southern Utah,W 103-65,200,40,73,.548,34,60,.567,6,13,.462,17,30,.567,103,27,55,.491,23,38,.605,4,17,.235,7,11,.636,65
363,2012-03-17,Gonzaga,N,Ohio State,L 66-73,200,22,56,.393,14,33,.424,8,23,.348,14,19,.737,66,25,53,.472,16,29,.552,9,24,.375,14,18,.778,73
364,2012-03-15,Gonzaga,N,West Virginia,W 77-54,200,28,50,.560,19,33,.576,9,17,.529,12,16,.750,77,16,49,.327,13,32,.406,3,17,.176,19,28,.679,54
365,2012-03-05,Gonzaga,N,Saint Mary's,L 74-78 (OT),225,30,69,.435,25,47,.532,5,22,.227,9,11,.818,74,28,63,.444,20,40,.500,8,23,.348,14,20,.700,78
366,2012-03-03,Gonzaga,N,BYU,W 77-58,200,29,53,.547,22,38,.579,7,15,.467,12,19,.632,77,20,53,.377,17,35,.486,3,18,.167,15,24,.625,58
367,2012-02-27,Gonzaga,,Longwood,W 92-60,200,35,64,.547,22,35,.629,13,29,.448,9,14,.643,92,23,58,.397,15,33,.455,8,25,.320,6,7,.857,60
368,2012-02-25,Gonzaga,@,San Diego,W 65-57,200,19,44,.432,12,31,.387,7,13,.538,20,27,.741,65,22,53,.415,16,30,.533,6,23,.261,7,15,.467,57
369,2012-02-23,Gonzaga,,BYU,W 74-63,200,16,41,.390,10,28,.357,6,13,.462,36,44,.818,74,24,78,.308,18,50,.360,6,28,.214,9,16,.563,63
370,2012-02-18,Gonzaga,@,San Francisco,L 65-66,200,24,47,.511,17,29,.586,7,18,.389,10,12,.833,65,26,53,.491,22,39,.564,4,14,.286,10,17,.588,66
371,2012-02-16,Gonzaga,@,Santa Clara,W 73-62,200,25,41,.610,22,32,.688,3,9,.333,20,27,.741,73,22,58,.379,12,37,.324,10,21,.476,8,11,.727,62
372,2012-02-11,Gonzaga,,Loyola Marymount,W 78-59,200,27,52,.519,20,31,.645,7,21,.333,17,19,.895,78,22,56,.393,16,33,.485,6,23,.261,9,12,.750,59
373,2012-02-09,Gonzaga,,Saint Mary's,W 73-59,200,28,53,.528,21,38,.553,7,15,.467,10,19,.526,73,21,55,.382,16,34,.471,5,21,.238,12,17,.706,59
374,2012-02-04,Gonzaga,@,Pepperdine,W 72-60,200,22,44,.500,15,28,.536,7,16,.438,21,28,.750,72,23,54,.426,15,33,.455,8,21,.381,6,12,.500,60
375,2012-02-02,Gonzaga,@,BYU,L 73-83,200,25,61,.410,22,42,.524,3,19,.158,20,28,.714,73,34,69,.493,31,57,.544,3,12,.250,12,17,.706,83
376,2012-01-26,Gonzaga,@,Portland,W 74-62,200,24,51,.471,23,40,.575,1,11,.091,25,31,.806,74,25,58,.431,19,37,.514,6,21,.286,6,10,.600,62
377,2012-01-21,Gonzaga,,San Diego,W 77-60,200,29,58,.500,25,47,.532,4,11,.364,15,20,.750,77,26,61,.426,21,44,.477,5,17,.294,3,6,.500,60
378,2012-01-19,Gonzaga,,San Francisco,W 74-63,200,23,47,.489,18,34,.529,5,13,.385,23,32,.719,74,22,52,.423,15,30,.500,7,22,.318,12,21,.571,63
379,2012-01-14,Gonzaga,@,Loyola Marymount,W 62-58,200,24,52,.462,22,39,.564,2,13,.154,12,18,.667,62,19,50,.380,13,33,.394,6,17,.353,14,18,.778,58
380,2012-01-12,Gonzaga,@,Saint Mary's,L 62-83,200,22,54,.407,15,39,.385,7,15,.467,11,18,.611,62,30,59,.508,21,34,.618,9,25,.360,14,19,.737,83
381,2012-01-07,Gonzaga,,Santa Clara,W 82-60,200,30,55,.545,24,38,.632,6,17,.353,16,21,.762,82,23,60,.383,17,41,.415,6,19,.316,8,8,1.000,60
382,2012-01-05,Gonzaga,,Pepperdine,W 73-45,200,25,61,.410,15,34,.441,10,27,.370,13,21,.619,73,13,46,.283,10,35,.286,3,11,.273,16,22,.727,45
383,2011-12-31,Gonzaga,@,Xavier,W 72-65,200,26,59,.441,18,40,.450,8,19,.421,12,17,.706,72,25,59,.424,22,41,.537,3,18,.167,12,19,.632,65
384,2011-12-28,Gonzaga,,Portland,W 90-51,200,29,53,.547,20,35,.571,9,18,.500,23,36,.639,90,19,64,.297,15,44,.341,4,20,.200,9,15,.600,51
385,2011-12-22,Gonzaga,,Air Force,W 70-60,200,21,45,.467,13,27,.481,8,18,.444,20,27,.741,70,22,42,.524,16,26,.615,6,16,.375,10,15,.667,60
386,2011-12-20,Gonzaga,,Butler,W 71-55,200,24,49,.490,15,31,.484,9,18,.500,14,21,.667,71,24,65,.369,18,40,.450,6,25,.240,1,4,.250,55
387,2011-12-17,Gonzaga,N,Arizona,W 71-60,200,24,56,.429,21,36,.583,3,20,.150,20,32,.625,71,23,56,.411,17,36,.472,6,20,.300,8,9,.889,60
388,2011-12-15,Gonzaga,,Oral Roberts,W 67-61,200,23,45,.511,16,24,.667,7,21,.333,14,19,.737,67,24,60,.400,19,45,.422,5,15,.333,8,13,.615,61
389,2011-12-10,Gonzaga,,Michigan State,L 67-74,200,19,44,.432,12,30,.400,7,14,.500,22,28,.786,67,26,48,.542,20,35,.571,6,13,.462,16,25,.640,74
390,2011-12-03,Gonzaga,@,Illinois,L 75-82,201,26,51,.510,21,38,.553,5,13,.385,18,27,.667,75,32,60,.533,27,44,.614,5,16,.313,13,17,.765,82
391,2011-11-30,Gonzaga,,Notre Dame,W 73-53,200,28,61,.459,22,46,.478,6,15,.400,11,15,.733,73,20,52,.385,18,38,.474,2,14,.143,11,18,.611,53
392,2011-11-26,Gonzaga,N,Western Mich.,W 78-58,200,30,57,.526,24,43,.558,6,14,.429,12,21,.571,78,20,48,.417,15,33,.455,5,15,.333,13,21,.619,58
393,2011-11-19,Gonzaga,N,Hawaii,W 73-54,200,24,60,.400,17,42,.405,7,18,.389,18,28,.643,73,20,53,.377,13,39,.333,7,14,.500,7,8,.875,54
394,2011-11-14,Gonzaga,,Washington St.,W 89-81,200,23,56,.411,10,27,.370,13,29,.448,30,37,.811,89,29,61,.475,20,41,.488,9,20,.450,14,21,.667,81
395,2011-11-11,Gonzaga,,Eastern Wash.,W 77-69,200,19,51,.373,16,38,.421,3,13,.231,36,51,.706,77,23,61,.377,10,32,.313,13,29,.448,10,11,.909,69
396,2011-03-19,Gonzaga,N,BYU,L 67-89,200,24,57,.421,22,48,.458,2,9,.222,17,21,.810,67,31,59,.525,17,31,.548,14,28,.500,13,15,.867,89
397,2011-03-17,Gonzaga,N,St. John's (NY),W 86-71,200,28,52,.538,19,37,.514,9,15,.600,21,26,.808,86,27,58,.466,20,43,.465,7,15,.467,10,15,.667,71
398,2011-03-07,Gonzaga,N,Saint Mary's,W 75-63,200,25,51,.490,21,42,.500,4,9,.444,21,26,.808,75,20,50,.400,13,35,.371,7,15,.467,16,21,.762,63
399,2011-03-06,Gonzaga,N,San Francisco,W 71-67,200,22,54,.407,19,40,.475,3,14,.214,24,29,.828,71,21,46,.457,16,29,.552,5,17,.294,20,26,.769,67
400,2011-02-28,Gonzaga,,Cal St Bakersfield,W 96-49,200,33,66,.500,22,37,.595,11,29,.379,19,20,.950,96,21,61,.344,17,40,.425,4,21,.190,3,10,.300,49
401,2011-02-26,Gonzaga,@,San Diego,W 68-31,200,21,43,.488,20,36,.556,1,7,.143,25,30,.833,68,12,47,.255,8,28,.286,4,19,.211,3,7,.429,31
402,2011-02-24,Gonzaga,@,Saint Mary's,W 89-85 (OT),225,31,55,.564,27,44,.614,4,11,.364,23,29,.793,89,29,60,.483,19,37,.514,10,23,.435,17,20,.850,85
403,2011-02-19,Gonzaga,,San Francisco,W 70-53,200,28,65,.431,20,40,.500,8,25,.320,6,8,.750,70,20,53,.377,14,36,.389,6,17,.353,7,10,.700,53
404,2011-02-17,Gonzaga,,Santa Clara,W 85-76,200,29,54,.537,23,40,.575,6,14,.429,21,31,.677,85,21,64,.328,9,35,.257,12,29,.414,22,28,.786,76
405,2011-02-12,Gonzaga,@,Pepperdine,W 63-44,200,22,57,.386,18,40,.450,4,17,.235,15,18,.833,63,17,62,.274,15,47,.319,2,15,.133,8,12,.667,44
406,2011-02-10,Gonzaga,@,Loyola Marymount,W 67-57,200,20,47,.426,18,39,.462,2,8,.250,25,34,.735,67,19,55,.345,15,42,.357,4,13,.308,15,19,.789,57
407,2011-02-05,Gonzaga,N,Memphis,L 58-62,200,19,53,.358,13,33,.394,6,20,.300,14,18,.778,58,22,57,.386,16,35,.457,6,22,.273,12,17,.706,62
408,2011-02-03,Gonzaga,@,Portland,W 67-64,200,26,53,.491,23,41,.561,3,12,.250,12,18,.667,67,20,54,.370,9,33,.273,11,21,.524,13,19,.684,64
409,2011-01-29,Gonzaga,,San Diego,W 86-53,200,32,54,.593,26,37,.703,6,17,.353,16,25,.640,86,17,48,.354,10,30,.333,7,18,.389,12,19,.632,53
410,2011-01-27,Gonzaga,,Saint Mary's,L 71-73,200,25,56,.446,20,43,.465,5,13,.385,16,20,.800,71,28,58,.483,20,35,.571,8,23,.348,9,13,.692,73
411,2011-01-22,Gonzaga,@,San Francisco,L 91-96 (OT),225,34,76,.447,26,55,.473,8,21,.381,15,27,.556,91,31,68,.456,24,46,.522,7,22,.318,27,32,.844,96
412,2011-01-20,Gonzaga,@,Santa Clara,L 71-85,200,20,42,.476,16,29,.552,4,13,.308,27,31,.871,71,25,49,.510,17,29,.586,8,20,.400,27,33,.818,85
413,2011-01-15,Gonzaga,,Loyola Marymount,W 79-59,200,32,62,.516,29,50,.580,3,12,.250,12,22,.545,79,15,55,.273,10,38,.263,5,17,.294,24,30,.800,59
414,2011-01-13,Gonzaga,,Pepperdine,W 92-75,200,35,56,.625,25,38,.658,10,18,.556,12,12,1.000,92,28,54,.519,21,41,.512,7,13,.538,12,18,.667,75
415,2011-01-08,Gonzaga,,Portland,W 74-61,200,23,55,.418,14,30,.467,9,25,.360,19,24,.792,74,24,46,.522,17,34,.500,7,12,.583,6,8,.750,61
416,2011-01-02,Gonzaga,@,Wake Forest,W 73-63,200,26,52,.500,23,43,.535,3,9,.333,18,22,.818,73,19,56,.339,15,39,.385,4,17,.235,21,27,.778,63
417,2010-12-31,Gonzaga,,Oklahoma State,W 73-52,200,24,53,.453,17,35,.486,7,18,.389,18,26,.692,73,21,58,.362,16,44,.364,5,14,.357,5,14,.357,52
418,2010-12-29,Gonzaga,,Lafayette,W 83-55,200,29,60,.483,23,42,.548,6,18,.333,19,28,.679,83,20,60,.333,8,29,.276,12,31,.387,3,8,.375,55
419,2010-12-22,Gonzaga,,Xavier,W 64-54,200,16,42,.381,14,34,.412,2,8,.250,30,34,.882,64,16,48,.333,12,30,.400,4,18,.222,18,25,.720,54
420,2010-12-18,Gonzaga,N,Baylor,W 68-64,200,22,53,.415,18,44,.409,4,9,.444,20,24,.833,68,18,49,.367,16,37,.432,2,12,.167,26,33,.788,64
421,2010-12-16,Gonzaga,,Lewis & Clark,W 103-61,200,37,61,.607,25,42,.595,12,19,.632,17,23,.739,103,20,62,.323,16,43,.372,4,19,.211,17,23,.739,61
422,2010-12-11,Gonzaga,@,Notre Dame,L 79-83,200,29,55,.527,18,35,.514,11,20,.550,10,12,.833,79,24,48,.500,13,28,.464,11,20,.550,24,36,.667,83
423,2010-12-08,Gonzaga,@,Washington St.,L 59-81,200,19,48,.396,15,30,.500,4,18,.222,17,21,.810,59,30,60,.500,19,39,.487,11,21,.524,10,17,.588,81
424,2010-12-04,Gonzaga,N,Illinois,L 61-73,200,24,59,.407,21,43,.488,3,16,.188,10,16,.625,61,24,54,.444,12,31,.387,12,23,.522,13,16,.813,73
425,2010-11-30,Gonzaga,,Eastern Wash.,W 86-57,200,33,57,.579,22,41,.537,11,16,.688,9,14,.643,86,21,62,.339,13,38,.342,8,24,.333,7,18,.389,57
426,2010-11-23,Gonzaga,N,Marquette,W 66-63,200,26,60,.433,20,43,.465,6,17,.353,8,13,.615,66,21,54,.389,15,33,.455,6,21,.286,15,21,.714,63
427,2010-11-22,Gonzaga,N,Kansas State,L 64-81,200,19,57,.333,16,44,.364,3,13,.231,23,29,.793,64,29,57,.509,17,31,.548,12,26,.462,11,20,.550,81
428,2010-11-16,Gonzaga,,San Diego State,L 76-79,200,25,52,.481,20,34,.588,5,18,.278,21,27,.778,76,33,65,.508,28,52,.538,5,13,.385,8,15,.533,79
429,2010-11-14,Gonzaga,,IUPUI,W 86-56,200,35,58,.603,30,40,.750,5,18,.278,11,19,.579,86,18,52,.346,14,29,.483,4,23,.174,16,20,.800,56
430,2010-11-12,Gonzaga,,Southern,W 117-72,200,39,72,.542,26,50,.520,13,22,.591,26,33,.788,117,24,58,.414,12,27,.444,12,31,.387,12,20,.600,72